 |A B C D E F G H
-+---------------
1|x 3 3 3 . . . .
2|2 4 4 4 4 . . .
3|. . . . . . . .
4|. . . . . . . .
5|. 5 5 5 5 5 . .
6|. . . . . . . .
7|. . . . . . . .
8|. . . . . . . .